NO ./textures/stone.xpm



SO ./textures/brick_with_flag.xpm



WE ./textures/stone_musgo.xpm



EA ./textures/wood.xpm



F 52,140,49

C 0,150,255





        1111111111111111111111111
        1N00000000110000000000001
        1011000001110000000000001
        1001000000000000000000001
111111111011000001110000000000001
100000000011000001110111111111111
11110111111111011100000010001
11110111111111011101010010001
11000000110101011100000000001
10000000000000001100000010001
10000000000000001101010010001
1100000111010101111101111000111
11110111 1110101 11111010001
11111111 1111111 111111111111
